Date,Description,Debit,Credit,Balance
2025-10-01,Opening Balance,,,10000.00
2025-10-02,Direct Debit - Office Rent,2500.00,,7500.00
2025-10-03,Customer Payment - ABC Corp,,5000.00,12500.00
2025-10-05,ATM Withdrawal,200.00,,12300.00
2025-10-07,Supplier Payment - XYZ Ltd,1500.00,,10800.00
2025-10-10,Interest Credit,,15.50,10815.50
2025-10-12,Utility Bill Payment,350.00,,10465.50
2025-10-15,Customer Payment - DEF Inc,,3000.00,13465.50
